R 1920 1080

NO ./srcs/textures/grass.xpm
SO ./srcs/textures/grass.xpm
WE ./srcs/textures/grass.xpm
EA ./srcs/textures/grass.xpm
S ./srcs/textures/grass.xpm

F 220,100,0
C 225,30,0

        1111111111111111111111111
        1000000000110000000000001
        1011000001110000002000001
        1001000000000000000000000
111111111011000001110000000000001
100000000011000001110111111111111
111101111111110111000000100000001
111101111111110111010100100000001
110000001101010111000000000000001
100020000000000000000000100000001
100000000000000011010100100000001
11000001110101011111011110N0000N0
11110111 1110101 1011110100000001
11111111 1111111 1111111111111111
