NO ./srcs/textures/eagle.xpm
SO ./srcs/textures/purplestone.xpm
WE ./srcs/textures/mossy.xpm
EA ./srcs/textures/redbrick.xpm

F 220,100,0
C 225,30,0


11111111
1E010001
11111111
