11111111
10000001
10000001
10000001
10000011
10000011
10000001
11111111