NO ./srcs/config/textures/eagle.xpm
SO ./srcs/config/textures/purplestone.xpm
WE ./srcs/config/textures/mossy.xpm
EA ./srcs/config/textures/redbrick.xpm
F 22,100,0


     11111
    1000001                
    100N001
    1000001
    1000001
    1000001
     10001
     10001
     10001
     10001                                1111111
 111110001111111111111111111           1110000000111
10000000000000000000000000001        11000000000000011
10000000000000000000000000111       1000000000000000001
10000000000000000100000000000111111100000000000000000001
 11110000000000001111110000000000000000000000000000000001
    1000000000001   1000000000000000000000000000000000001
    1000000000001   100000000111111100000000000000000001
    10000000000001111000000111      1000000000000000001
 111000000000000000000000001         11000000000000011
1000000000000000100000111111           1110000000111
1000000111110000000001                    1100001
1000001     100000001       111111111111111100001
1000001     100000001       100000000000000000001
 11111       1111111        11111111111111111111

C 225,30,0