NO ./srcs/config/textures/eagle.xpm
SO ./srcs/config/textures/eagle.xpm
EA ./srcs/config/textures/eagle.xpm
WE ./srcs/config/textures/eagle.xpm

F 220,100,0
C 225,30,0








111
10111
100N1
11111
